1 1 1 1 1 1 1 1
1 0 b 0 0 0 0 1
1 0 0 0 0 0 0 1
1 1 0 1 1 1 1 1
1 0 0 0 0 A 0 1
1 1 1 1 1 1 1 1
