11111111
10030201
10000001
13030301
10000001
11111111
