111111111111111111111111
100000000000000000000001
100000000000000000000001
100000000000000000000001
100022222220000303030001
100027200020000000000001
100020200020000307030001
100000200020000000000001
100022220220000303030001
100000000000000000000001
106000000000000000000001
106000000000000000000001
100000000000000000000001
100044444000000000000001
106040004000050000050001
106040704000005000500001
100040004000055555550001
144444404000550555055001
140000004005555555555501
140400004005055555550501
140444444005050000050501
140000000000005505500001
144444444000000000000001
111111111111111111111111
