# https://github.com/faiface/pixel-examples/blob/704acac0e5f6fc19b27d5772033d77fc58cb7d59/community/raycaster/raycaster.go#L40
1 1 1 1 1 1 1 1 1 1 1 1 1 1 1 1 1 1 1 1 1 1 1 1
1 0 0 0 0 0 0 0 0 0 0 0 0 0 0 0 0 0 0 0 0 0 0 1
1 0 0 0 0 0 0 0 0 0 0 0 0 0 0 0 0 0 0 0 0 0 0 1
1 0 0 0 0 0 0 0 0 0 0 0 0 0 0 0 0 0 0 0 0 0 0 1
1 0 0 0 2 2 2 2 2 2 2 0 0 0 0 3 0 3 0 3 0 0 0 1
1 0 0 0 2 7 2 0 0 0 2 0 0 0 0 0 0 0 0 0 0 0 0 1
1 0 0 0 2 0 2 0 0 0 2 0 0 0 0 3 0 7 0 3 0 0 0 1
1 0 0 0 0 0 2 0 0 0 2 0 0 0 0 0 0 0 0 0 0 0 0 1
1 0 0 0 2 2 2 2 0 2 2 0 0 0 0 3 0 3 0 3 0 0 0 1
1 0 0 0 0 0 0 0 0 0 0 0 0 0 0 0 0 0 0 0 0 0 0 1
1 0 6 0 0 0 0 0 0 0 0 0 0 0 0 0 0 0 0 0 0 0 0 1
1 0 6 0 0 0 0 0 0 0 0 0 0 0 0 0 0 0 0 0 0 0 0 1
1 0 0 0 0 0 0 0 0 0 0 0 0 0 0 0 0 0 0 0 0 0 0 1
1 0 0 0 4 4 4 4 4 0 0 0 0 0 0 0 0 0 0 0 0 0 0 1
1 0 6 0 4 0 0 0 4 0 0 0 0 5 0 0 0 0 0 5 0 0 0 1
1 0 6 0 4 0 7 0 4 0 0 0 0 0 5 0 0 0 5 0 0 0 0 1
1 0 0 0 4 0 0 0 4 0 0 0 0 5 5 5 5 5 5 5 0 0 0 1
1 4 4 4 4 4 4 0 4 0 0 0 5 5 0 5 5 5 0 5 5 0 0 1
1 4 0 0 0 0 0 0 4 0 0 5 5 5 5 5 5 5 5 5 5 5 0 1
1 4 0 4 0 0 0 0 4 0 0 5 0 5 5 5 5 5 5 5 0 5 0 1
1 4 0 4 4 4 4 4 4 0 0 5 0 5 0 0 0 0 0 5 0 5 0 1
1 4 0 0 0 0 0 0 0 0 0 0 0 0 5 5 0 5 5 0 0 0 0 1
1 4 4 4 4 4 4 4 4 0 0 0 0 0 0 0 0 0 0 0 0 0 0 1
1 1 1 1 1 1 1 1 1 1 1 1 1 1 1 1 1 1 1 1 1 1 1 1
